NO ./path_to_the_north_texture
SO ./path_to_the_south_texture
WE ./path_to_the_west_texture
EA ./path_to_the_east_texture

F 2,100,155
C 255,30,0


      11111
      10101
      10101
      10101
      10101
      10101
111111101011111
100000000000001
100000000000001   
1000000N0000001
100000000000001
111111111111111