NO ./Assets/Textures/Wall_A_16.xpm
SO ./Assets/Textures/Wall_B_16.xpm
WE ./Assets/Textures/Wall_C_16.xpm
EA ./Assets/Textures/Wall_D_16.xpm

F 255,30,0 
C 2,50,75


      11111
      10101
      10101
      10101
      10101
      10101
111111101011111
100000000000001
100000010000001   
1000000N0000001
100000000000001
111111111111111