NO ./Assets/Textures/Wall_A_16.xpm
SO ./Assets/Textures/Wall_B_16.xpm
WE ./Assets/Textures/Wall_C_16.xpm
EA ./Assets/Textures/Wall_D_16.xpm

C 135,206,235
F 112, 128, 144

111111111111111
100000000000001
100100010000001   
1001000E0010001
100000000000001
111111111111111
